NO W1.xpm
SO W2.xpm
WE W3.xpm
EA W4.xpm
F 220,100,0
C 225,30,0

1111111111111111111111111
1000000000000000000000001
1000000000010000000000001
1000000000000000000000001
1011111101110111111111111
1111111110110000011100001
100001000000000001110111111111111
11110110111111011100000010001
11110110111111011101010010001
10000000000000001100000010001
10000000000000001100000010001
10000000100000001101010010001
1100000000000001111011110N0111
1111011111110001 101111010001
11111111 1111111 111111111111