NO ./path_to_the_north_texture
SO ./path_to_the_south_texture
WE ./path_to_the_west_texture
EA ./path_to_the_east_texture
F 220,100,0
C 225,30,0
    1111111111111111111111111
    10000000N0010000000000001
    1011111110110111111111111
1111100010000010000000000001
1011111101110111111111001001
1111111110110100011100000001
100001000000010001110111111111111
11110110111101011100000011011
11110110111101011101010010001
10000000000000000101010010001
10000000000000000101010010001
10001000100010000101010010001
10000000000000000101011010001
10000000000000000001000010001
11111111111111111111111111111