NO img/W_5.xpm
SO img/W_6.xpm
WE img/W_7.xpm
EA img/W_8.xpm
F 105,45,33
C 50,139,168

1111111111111111111111111
1000000000000000000000001
1000000000010000000000001
1000000000000000000000001
1011111101110111111111101
1011111110110000011100001
100001000000000001110111111111111
11110110111111011100000010001
11110110111111011101010010001
10000000000000001100000010001
10000000000000001100000010001
10000000100000001101010010001
110000000000000111000000N0111
1111011111110001 101111010001
11111111 1111111 111111111111