NO img/W_5.xpm
SO img/W_6.xpm
WE img/W_7.xpm
EA img/W_8.xpm
F 105,45,33
C 50,139,168

11111111111111111111111111111
10000000000000000000000000001
10000000000100000000000011011
10000000000000000000000011011
10111111011111111111111010001
10100001011000000000000010001
100001110000000001110111110111111
101111110100001000100000010001
100000011100001000100000010001
11111101111111111101010010001
10000001000010001100000010001
10000000000010001000000010001
10111111111110111001111110001
100000000000000010010000E0011
10000001000000001001000010001
10111111111011111111111111101
10000000000000000000000000001
11111111111111111111111111111