

111111111111   1111111111
100000000011   1000000001111
11111011000011111111000000001
1001000000011111000000000111
1111111101100000111000001
10000000001100000111011111111111
11110111111111011100000010001
11110111111111011101010010001
11000000110101011100000010001
1000000000000001100000011111111111
100000000000000110101001000000N01
110000011101010111110111101111111
11110111 1110101 101111011111
11111111 111111 111111111111