

111111111111   1111111111
10000E000011   1000000001
101100000111   1000000001
10010000000111110000000001
11111111101100000111000001
100000000011000001110111111111111
11110111111111011100000010001
11110111111111011101010010001
11000000110101011100000010001
10000000000000001100000011111
10000000000000001101010010001
11000001110101011111011110N0111
11110111 1110101 101111011111
11111111 1111111 111111111111