NO img/S_W4.xpm
SO img/S_W1.xpm
WE img/S_W2.xpm
EA img/S_W3.xpm
F 105,45,33
C 50,139,168


11111111111111111111111111111111111111
1000000000000000000000000000000000W001
10000000000000000000000000000000000001
10011111111111111111111111111111111001
10010000200001010000001010001000001001
10010000100001010000001010002000001001
10011211111211011121111011111000001001
10010000100001010000000010002000001001
10010000100001010000000010001000001001
10010011111001010000001210001112111001
10000020002001011111111010001000000001
10010010001001010000001010001000001001
10011111211111011121111110001000001001
10000000000000000000000100001001001001
10000000000000000000000100001001001001
10011111111101112111100100001111001001
10010000000101000000100111111002001001
10010000000201000000100000000001001001
10010000000101000000100000000001001001
10011111111101111111111111111111111001
10000000000000000000000000000000000001
10000000000000000000000000000000000001
11111111111111111111111111111111111111