NO img/NW_1.xpm
SO img/NW_5.xpm
WE img/NW_3.xpm
EA img/NW_4.xpm
F 105,45,33
C 50,139,168


11111111111111111111111111111111111111
1000000000000000000000000000000000S001
1000000000000000000000000000000000000111111111
1001111111111101111111111111111111100A00000001
1001000000000101000000101000100000100111J11101
1001000010000101000000101000000000100100000101
100110111110110111A111101111100000A00100000K01
1001000010000101000000001000A00000100100000101
1001000010000101000000001000100000100111H1A101
10010111111101010000001A1000111A111001   10101
100100A000A001011111111010001000001001   10001
10010010001001010000000010001000001001   1011J11
10011111A111110111A1111110001000001001   1000001
10000000000000000000000100001001001001   1000001
10000000000000000000000100001001001001   1000001
100111J111110111A111100100001111001001   1000001
1001000000010100000010011111100A001001   101O111
100I0000000A0I000000K00000000001001001   1001
10010000000101000000100000000001001001   1001
100111H111110111H1111111111111111110011111001
100000000000000000000000000000000000000000001
100000000000000000000000000000000000011111111
11111111111111111111111111111111111111