  NO aelidrys/box.xpm
SO ./path_to_the_south_texture

WE ./path_to_the_west_texture
EA ./path_to_the_east_texture
F 220,100,0
C 225,30,0

1111111111
1000110001
1000010001
1111001111
1000100001
10001100N1
1111111111