NO img/NW_1.xpm
SO img/NW_5.xpm
WE img/NW_3.xpm
EA img/NW_4.xpm
F 105,45,33
C 50,139,168


1111111111111111111111111111111111j111
1000000000000000000E000000000000000001
1000000000000000000000000000000000000111111111
10011111111111011111111111111111111000a0000001
1001000000000101000000101000100000100111j11101
1001000010000101000000101000000000100100000101
100110111110110111a111101111100000a00i00000k01
1001000010000101000000001000a00000100100000101
1001000010000101000000001000100000100111h1a101
10010111111101010000001a1000111a111001   10101
100100a000a001011111111010001000001001   10001
10010010001001010000000010001000001001   1011111
10011111a111110111a1111110001000001001   1010001
10000000000000000000000100001001001001   101j001
100111j1j11110111a11110100001111001001   100a001
1001000000001010000001011111100a001001   101h111
100i00000000a0i000000k0000000001001001   1001
10010000000010100000010000000001001001   1001
1001111hh11110111h111111111111111110011111001
100000000000000000000000000000000000000000001
100000000000000000000000000000000000011111111
11111111111111111101111111111111111111
                 1ak
                 101
                 101
                 101
             111110111111
             100000000001
             i0000000000k
             100000000001
             i0000000000k
             100000000001
             111110111111
                 101
                 101  11111111111
                 1011110000000001
                 100000000000000111111
111111111111111  111111000000000000001
100000010000001       1111111111111101
100000010000001                    101
101a100101a1001                    101
11101111110111111111111111111111111101
10000000000000000000000000000000000001
11101111110111111111111111111111111111
101a100101a1001
100000010000001
100000010000001
111111111111111