NO img/metal_3.xpm
SO img/metal_2.xpm
WE img/metal_1.xpm
EA img/metal_1.xpm
F 105,45,33
C 50,139,255


11111111111111111111111111111111111111
10000000000000000S00000000000000000001
10000000000000000000000000000000000001
10000000000000000000000000000000000001
10000000000111111a11111110000000000001
10000000000100000000000010000000000001
10000000000100000000000010000000000001
10000000000100000000000010000000000001
10000000000100000000000010000000000001
10000000000100000000000010000000000001
10000000000100000000000010000000000001
10000000000100000000000010000000000001
10000000000100000000000010000000000001
10000000000100000000000010000000000001
10000000000100000000000010000000000001
10000000000100000000000010000000000001
10000000000100000000000010000000000001
100000000001a1a1a1a1a1a110000000000001
10000000000101010101010110000000000001
1s0s0s0s0s01s1s1s1s1s1s11s0s0s0s0s0s01
11111111111111111111111111111111111111