NO img/W_5.xpm
SO img/W_5.xpm
WE img/W_5.xpm
EA img/W_5.xpm
F 105,45,33
C 50,139,168
             1
           11S11
           10001
           10001
           n000t
           10001
           n000t
           10001
           n000t
           10001
           n000t
           10001
           n000t
           10001
           n000t
           10001
           n000t
         11n000t11
11111111100000000011111111111
10000000100000000010000000001
10000000n000000000t0000000001
1n000000a000000000a00000000t1
10000000n000000000t0000000001
10000000100000000010000000001
11111111100000000011111111111
n000000000000000000000000000t
10000000000000000000000000001
n000000000000000000000000000t
11111111111111111111111111111