NO img/wall_black.xpm
SO img/wall_black.xpm
WE img/wall_black.xpm
EA img/wall_black.xpm
F 105,45,33
C 50,139,168


11111111111111111111111111111111111111
1E000000000000000000000000000000000001
10000000000000000000000000000000000001
111111a1111111111111a11111111111a11111
1m00000000000l1m00000000000l1m000000l1
1m00000000000l1m00000000000l1m000000l1
1m00000000000l1m00000000000l1m000000l1
1m00000000000l1m00000000000l1m000000l1
1m00000000000l1m00000000000l1m000000l1
11oooo0ooooo1111ooooo0oooo1111oo0oo111
111111a11111111111111a1111111111a11111
1m00000000000lm00000000000lm00000000l1
1m00000000000lm00000000000lm00000000l1
1m00000000000lm00000000000lm00000000l1
1m00000000000lm00000000000lm00000000l1
11oooooooooooooooooooooooooooooooooo11
11111111111111111111111111111111111111