NO img/wall_ston_neon.xpm
SO img/wall_ston_neon.xpm
WE img/wall_ston_neon.xpm
EA img/wall_ston_neon.xpm
F 105,45,33
C 50,139,168


11111111111111111111111111111111111
100000000000000S0000000000000000001
10000000000000000000000000000000001
10000000000000000000000000000000001
10000000000000000000000000000000001
10000000000000000000000000000000001
10000000000000000000000000000000001
10000000000000000000000000000000001
10000000000000000000000000000000001
10000000000000000000000000000000001
10000000000000000000000000000000001
100000000001q1q1a1q1q10000000000001
1000000000pr000000000pr000000000001
100000000pp10000000001rr00000000001
10000000pppr000000000prrr0000000001
1000000pppp10000000001rrrr000000001
100000pppppr000000000prrrrr00000001
1000000pppp10000000001rrrr000000001
10000000pppr000000000prrr0000000001
100000000pp10000000001rr00000000001
1000000000pr000000000pr000000000001
100000000001q1q1a1q1q10000000000001
10000000000000000000000000000000001
10000000000000000000000000000000001
10000000000000000000000000000000001
10000000000000000000000000000000001
100000000000000qqq00000000000000001
10000q000000000p0r0000000000q000001
1000qqq00000000p0r000000000qqq00001
100qqqqq0000000p0r00000000qqqqq0001
11111111111111111111111111111111111