NO img/wall_wood_dark.xpm
SO img/wall_wood_dark.xpm
WE img/wall_wood.xpm
EA img/wall_wood.xpm
F 105,45,33
C 50,139,1680


11111111111111111111111111111111111111
1000000000000000000000000000000000W001
10000000000000000000000000000000000001
10011111111111111111111111111111111001
10010000a00001010000001010001000001001
1001000010000101000000101000a000001001
10011a11111a110111a1111011111000001001
1001000010000101000000001000a000001001
10010000100001010000000010001000001001
10010011111001010000001a1000111a111001
100000a000a001011111111010001000000001
10010010001001010000001010001000001001
10011111a111110111a1111110001000001001
10000000000000000000000100001001001001
10000000000000000000000100001001001001
1001111111110111a111100100001111001001
1001000000010100000010011111100a001001
1000000a000a01000000100000000001001001
10010000000101000000100000000001001001
10011111111101111111111111111111111001
10000000000000000000000000000000000001
10000000000000000000000000000000000001
11111111111111111111111111111111111111