NO img/wall_wood_dark.xpm
SO img/wall_wood_dark.xpm
WE img/wall_wood.xpm
EA img/wall_wood.xpm
F 105,45,33
C 50,139,168


11111111111111111111111111111111111111
1000000000000000000000000000000000W001
10000000000000000000000000000000000001
10011111111111111111111111111111111001
10010000A00001010000001010001000001001
1001000010000101000000101000A000001001
10011A11111A110111A1111011111000001001
1001000010000101000000001000A000001001
10010000100001010000000010001000001001
10010011111001010000001A1000111A111001
100000A000A001011111111010001000000001
10010010001001010000001010001000001001
10011111A111110111A1111110001000001001
10000000000000000000000100001001001001
10000000000000000000000100001001001001
1001111111110111A111100100001111001001
1001000000010100000010011111100A001001
1000000A000A01000000100000000001001001
10010000000101000000100000000001001001
10011111111101111111111111111111111001
10000000000000000000000000000000000001
10000000000000000000000000000000000001
11111111111111111111111111111111111111