NO S_W4.xpm
SO S_W1.xpm
WE S_W2.xpm
EA S_W3.xpm
F 105,45,33
C 50,139,168


11111111111111111111111111
10000000000000000001000001
1111D1111D10000N000D000001
100000001010000000010001D1
1000100010111D11110111110111
10100010101000000101000000011
100010001010000001D1001111D111111
100000001010000001010000100000001
1111D111101111D111010000100000001
100000000000000010010000100111101
1111111110111D1110010000100100101
100000001010000010010000100D00101
10000000D010000010000110000111101
100000001010000010001111000000001
111111111111111111111111111111111