NO S_W1.xpm
SO S_W2.xpm
WE S_W3.xpm
EA S_W3.xpm
F 220,100,0
C 225,30,0

11111111111111111111111111
10000000001000000000000001
10000000101000000000000001
10000000101000000000000001
1111111110100111111111110111
10000111101000000111000000011
100001100010000001110011110111111
100001101010000001110001010001
11110110101111011101110010001
10000000100000001101000010001
10001000100000001101000010001
10001000100000001101000010001
1100000010000000110001110N0001
111101111111100000001111000001
11111111 11111111111111111111