NO W0.xpm
SO Ww.xpm
WE S_W3.xpm
EA S_W3.xpm
F 105,45,33
C 50,139,168


11111111111111111111111111
10000000001000000000000001
11111111101000000000000001
10000000101000000000000001
1000100010100111111111110111
10100010101000000111000000011
100010001010000001110011110111111
10000000101000000111000010001
11110111101111011101000010001
10000000000000001001000010001
11111111101110111001000010001
10000000101000001001000010001
1000000000100000100001100N0001
100000001010000010001111000001
11111111111111111111111111111