1111111111
1000000001
1000000001
11110N1111
1000000001
1000000001
1111111111