1111111111
1000101001
1001010101
1010000101
1001101001
1N00000001
1111111111