1111111111
1000110001
1000000001
1111001111
1000000001
1N00110001
1111111111