1111111111
1000000001
1010000101
1N00000001
1111111111