1111111111
1000000001
1000111001
1001000101
1000111001
1N00000001
1111111111