NO ./path_to_the_north_texture
WE ./path_to_the_west_texture
SO ./path_to_the_south_texture
EA ./path_to_the_east_texture

F 220,100,0
C 225,30,0

    111111111111   1111111111
    100000000011   1000000001
11111011000001111111000000001
1001000000011111000000000111
1111111101100000111000001
10000000001100000111011111111111
11110111111111011100000010001
1111011 11111011101010010001
11000111110101011100000010001
1000000000000001100000011111
1000000000000000110101W010001
11000001110101011111011110111
11110111 1110101 101111011111
11111111 1111111 111111111111